22222222222222222222222222222222
00000000000000000000000000000000
00000000000000000000000000000000
00000000000000000000000000000000
000000000000000000000100000B0000
00001000000000000000102222222222
00000010000000000010000000000000
000000000000000000100000000B000D
00K00000000010010000000222222222
00111000000100000000020000000001
0000000100000000000K200000000000
00000000010000000002000000000000
0B0M0000000000000000000000000000
222222222222200000000000000B0000
00000B00000000000000000000000000
2222222222222P000000000000000000
000000000000M00000A0000000000000
22222222222222222222222222222222