00000000000000000000000000000000
00000000000000000000000000000000
00000000000000000000000000000000
00000000000000000000000000000M00
00000000000000000000000B0000KP00
11100002220000000001111111111P00
0000P000000002220000000000000000
00000P0000000000000000000E000000
0B000000000000000000000000000000
PPPP0PPP000000000B00000000000000
000P00000000000PPPPPPP0000000B0P
00000P000000PPP0000000000PPPPPPP
000000P00PP0M00P0000PPPP000000PP
0000P00000P00PP0P000PP0000000000
0000KP00P03PPPPPPPP000000P00K00P
000P0P00PPP00000000000000000000P
0000000000B00000000P0PPPPPPP00BD
22222222222222222222222222222222