00000000000000000000000000000000
00000000000000000000000000000000
00000000000000000000P00000000000
00000000000000000000000000000000
0000000P000000000000000000000000
00000000000000000000000000000000
00000000000000000000000000000000
00000000000000000000000000000000
00000000000000000000000000000000
000000000000PPPP0000001000000000
00000000000000000000030000000000
00000000PPPP0000PPPP000000000000
00000000000000000000000000000000
000PPPP0000000000000000PPPP00000
00000000100000002000000000000000
PPPP000000000000000000000000PPPP
00000000000000000000000000000000
PPPPPPPPPPPPPPPPPPPPPPPPPPPPPPPP