00000000000000000000000000000000
00000000000000000000000000000000
00000000000000000000000000000000
00000000000000000000000000000000
0000000P000000000000000000000000
000000000000000000000000B0000000
00000000000000000000000333000000
00000000000000000000003000200000
00000000000000000000000000000000
000000000000PPPP0000001000000000
00000000000300000000030000000002
00000000PP2P0000PPPP000000000200
00000000000000002000000000000200
000PPPP0000000000000000000P0000K
0000000020000000200000000B002000
PPPP00000M000000C00000002000PPPP
0000000K0000B00000M000000000000D
PPPPPPPPPPPPPPPPPPPPPPPPPPPPPPPP