00000000000000000000000000000000
00000000000000000000000000000000
00000000000000000000000000000000
00000000000000000000000000000000
0000000P000000000000000000000000
00000000000000000000000000000000
00000000000000000000000333000000
00000000000000000000003000200000
00000000000000000000000000000000
000000000000PPPP0000001000000000
00000000000300000000030000000002
00000000PP2P0000PPPP000200000200
00000000000000002000000000000200
000PPPP0000000000000000000P00000
00000000200000002000000000002000
PPPP000000000000000000000000PPPP
00000000000000000000000000000000
PPPPPPPPPPPPPPPPPPPPPPPPPPPPPPPP