00000000000000000000000000000000
00000000000000002000000000000000
00000000000000002222222222222222
00000000000000000000000000000000
00000000000000000200000000000000
00000000000002222111111111111111
000000000000022B0000000000000000
00000000000002222222222022202222
00000000000002222222222222222222
PPPPP000000002222222222222222222
00000000000000000000000000000000
0000000000000P00PPPPP00PPPPPPPPP
0000000000000P000000000000000000
000000000000PPPPPPPPPPPPPPPPPPPP
00000000000000000000000000000000
00000000000000000000000000000000
000000000000000000000000000P0000
22222222222222222222222222222222