PPPPPPPPPPPPPPPPPPPPPPPPPPPPPPPP
00000000000000020000000000000000
00000000000000000000000000000000
00000000000000000000000000000000
000000000000000000000100000B0000
00001000000000000000102222222222
00000010000000000010000000000000
000000000000000000100000000B000D
00K00000000010010200000222222222
00111000000100000000020000000001
0000000100000000000K200000000000
00000000010000000222000000000000
0B0M0000000000000000000000000000
2222222222222000000000000000000M
00000B000000000000000000000000PP
2222222222222P00000000000000PP0P
0000000B0000M00000A000B00000P000
22222222222222222222222222222222