PPPPPPPPPPPPPPPPPPPPPPPPPPPPPPPP
00000000000000000000000000000000
00000000000000000000000000000000
PPPPPPPPPPPPPPPPPPPPP00PPPPPPPPP
0000000000000000000000000000000P
00000000000000000000000000PPPPPP
0000000000000PPPPPPPPPPPPP000000
0000000B00PP000000000000P0P00000
00000PPPPP0000000C000000P0PK0000
P0000P0000000000000000000PPPPPPP
PPP000000000PPPPPPPP0B0000000000
000PPPPPPPPPPPPPPPPPPPPPPPPPP00P
D0B0000000000000000000000000000P
PPP0000000000000PPPPP000PPP000PP
PPPP00000000000C000000P000PPPPPP
0000P000000000000000000000P00000
00000P0B000000000000000B0000000K
22222222222222222222222222222222