PPPPPPPPPPPPPPPPPPPPPPPPPPPPPPPP
00000000000000000000000000000000
00000000000000000000000000000000
00000000000000000000000000000000
0000000P000000000000000000000000
00000000000000000000000B00000000
00000000000000000000000333P00000
00000000000000000000PP30002P0000
0000000000000000PPPP00000000P000
000000000000PPPP0000001000PPP000
0000000000030000000003000P000002
00000000PP2P0000PPPP000000000P00
00000000P00000002000000000000P00
000PPPP1100000000000000000P0000K
0000100020000000200000000000P000
PPPP00000M000000000000002000PPPP
B000000K00000000B0M0000000B0000D
PPPPPPPPPPPPPPPPPPPPPPPPPPPPPPPP