00000000000000000000000000000000
00000000000000000000000000000000
00000000000000000000000000000000
00000000000000000000000000000000
0000000P000000000000000000000000
00000000000000000000000000000000
00000000000000000000000333000000
00000000000000000000003000200000
00000000000000000000000000000000
000000000000PPPP0000001000000000
00000000000300000000030000000002
00000000PP2P0000PPPP000000000200
00000000000000002000000000000200
000PPPP00000000000000000K0P00000
00000000200000002000000000002000
PPPP00000M00000000000A000000PPPP
0000000K0000B00000M00B0000000000
PPPPPPPPPPPPPPPPPPPPPPPPPPPPPPPP