PPPPPPPPPPPPPPPPPPPPPPPPPPPPPPPP
00000000000000000000000000000000
00000000000000000000000000000000
00000000000000E00000000000000M00
00000000000000000000000B0000KP00
1110000P220000000001111111111P00
0000P000000002220000000000000000
00000P00000000000000000000000000
0B000000000000000000000000000000
PPPP0PPP000000000B00000000000000
000PE000000000PPPPPPP0000000B0P0
00000P00000PPPP0000000000PPPPPPP
000000P00PP0000P0000PPPP000000PP
0000P00000P00PP0P000PP0000000000
0000KP00P03PPPPPPPP000000P00K00P
000P0P00PPP00000000000000000000P
B000000000B00000000PPPPPPPPPB00D
22222222222222222222222222222222